NO ./img/texture_n.xpm
SO ./img/texture_s.xpm
WE ./img/texture_w.xpm
EA ./img/texture_e.xpm

F 220,100,0
C 225,255,255

111111111111111111111111
100000000000000000000001
100000000001000000000001
100000000000000000000001
100100000000000000000101
100000000000N00000000101
100000000000000000000111
111111111111111111111111
