NO ./img/texture_n.xpm
SO ./img/texture_s.xpm
WE ./img/texture_w.xpm
EA ./img/texture_e.xpm

F 220,100,0
C 225,30,0

111111111111111111111111
100000000000000010000001
100000000000000010000001
100010000N00000000000001
111111111111111111111111
