NO texture_n.xpm

SO texture_s.xpm

WE texture_w.xpm

EA texture_e.xpm


F 220,100,0
C 225,30,0



    1111111111111111111111111
11111000000000000000000011111
1000000000000000100000011
100000000000000000000001
100000000000000000000001
100000000000000000000001
1000000000000000100000011111
1000000000000000000000000001
100010000W000000000000011111
100000000000000000000001
100000000000000000000001
1000000111000000000000011
10000001 1000000000000001
11000001 1010101110000011
11110111 1110101 1011111
111111111111111111111111
