NO ./path_to_the_north_texture

SO ./path_to_the_south_texture

WE ./path_to_the_west_texture

EA ./path_to_the_east_texture


F 220,100,0
C 225,30,0



     111111111111111111111111
11111000000000000000000011111
100000000000000010000001
100000000000000000000001
100000000000000000000001
100000000000000000000001
100000000000000010000001111
1000000000000000000000000001
100010000W00000000000001111
100000000000000000000001
100000000000000000000001
100000011100000000000001
10000001 1000000000000001
11000001 101010111000001
11110111 1110101 1011111
111111111111111111111111
