NO ./path_to_the_north_texture
SO ./path_to_the_south_texture
WE ./path_to_the_west_texture
EA ./path_to_the_east_texture

F 220,100,0
C 225,30,0

  1111111111111111111111111111111
1110000000000000000011111
100000000000000010000001
100000000000000000000001
100000000000000000000001
100000000000000000000001
100000000000000000001111
100000000000000000000001
100010000W00000000001111
100000000000000000000001
100000000000000000000001
100000011100000000000001
100000011000000000000001
110000011010101011000001
111101111110001011011111
111111111111111111111111
